NO ./textures/north
C 225,30,0
EA ./textures/east


F 220,100,0



SO ./textures/south
WE ./textures/west



        111111111111111111111111
        1100000000001001110000111111111
        1100000011110000000000111111
        1100000010000000010001110001
111111111111111110000000000000111111111111
1S100000000000000000000000000111111110011111
100000000000001111100000000001111111000000111
10000000000000101000000000011111110000001111
1000000000000011111000000000001111111000000111
100000000000000000000000000000000000011111111
1111111000000000000000000000000000000111111
11111111111111111111111000000000000011111111
    11111111111111110000000000000011111111111
11111111111111111111111111111111111111111
