C 36,42,107
F 33,35,38

NO ./textures/north.xpm
EA ./textures/east.xpm
SO ./textures/south.xpm
WE ./textures/west.xpm

        111111111111111111111111
        1100000000001001110000111111111
        11000000111100000D0000111111
        1100000000010000010001110001
11111111111111111001010001000111111111111
1000000010000000100101000100111111110011111
1000LL0010PPPPP01111011111101111111000000111
1E00000000000000000000000111111100000111111
1000000010000000111111101111111111000000111
1000LL0010PPPPP0100000000000000010000011111111
11111111100000001000000000000000000111111
        11111111111100000000000101000011111
        1111111111110000000000000011111111111
        111111111111111111111111111