C 36,42,107
F 33,35,38

NO ./textures/north.xpm
EA ./textures/east.xpm
SO ./textures/south.xpm
WE ./textures/west.xpm

        11111111111111111111111
        11000000000010011100001                              1111111111111111
        11000000111100000D00F01                              1B000000000000B1
        11000000000100000100011                111  111      10PPPPPPPPPPPP01
111111111111111111111100010001111111111        1L1  1B1      10P0B00BB00B0P01
100000001111111111101100010011111111BB1111111111D1111D111111110P0LLLLLLLL0P01
10000L001PPPPPP1111D1111110111111100L00L0L0L0L0L0L0L0L0L00D000000000F00F00001
1E000F00D0000000000000000D111111B00001111111111111111D111111110P0LLLLLLLL0P01
10000L001PPPPPP1111111D1111111111D10L0P111          1P1      1FP0B00BB00B0P01
10000000111111111B10000000000000001000P111          111      10PPPPPPPPPPPP01
1111111111111111100000011111000000D11111                     1B000000000000B1
        1111111111110L010L0D00011111                         1111111111111111
        111F11111111B0010F01B00D00B1
        1111111111111111111111111111