NO ./textures/north.xpm
C 225,30,0
EA ./textures/east.xpm

F 220,100,0

SO ./textures/south.xpm
WE ./textures/west.xpm

        111111111111111111111111
        1100000000001001110000111111111
        1100000011110000000000111111
        1100000010000000010001110001
11111111111111110000000000000111111111111
1D00000000000000000000000000111111110011111
1N000B000000001111100000000001111111000000111
1000000000001010000000000111111100000111111
11111111111111111000000000001111111000000111
10000000000000000000000000000000101000011111111
11111110000000000000000000000000000111111
1111111111111111111111100000000101000011111
    11111111111111110000000000000011111111111
11111111111111111111111111111111111

