NO ./textures/north
SO ./textures/south
WE ./textures/west
EA ./textures/east

F 220,100,0
C 225,30,0


		 	111111111111111111111
		 	100000000001000000001111
		 	1000000111100000000001
		 	100000010000000010001110
111111111111111110000000000000111111111111
100000000000000000000000000011111111001
10000000000000000000000001111111000000111
10000000000000000000000000000000000001111
1111111000000000000000000000000000000111111
11111111111111111111111000000000000011111111
11111111111111100000000000000000011111111111
1111111111111111111111111111111111111111111111