NO ./textures/north
C 225,30,0
EA ./textures/east



F 220,100,0





SO ./textures/south
WE ./textures/west



		 	11111111111111111111xxxxxxxxxxxxxxxx
		 	100000000001000000001111xxxxxxxxxxxx
		 	100000011110000000000111111xxxxxxxxx
		 	100000010000000010001110001xxxxxxxxx
111111111111111110000000000000111111111111xxxxxx
10000000000000000000000000001111111100xxxxxxxxxx
100000000000001111100000000001111111000000111xxx
10000000000000101000000000001111111000000111xxxx
1000000000000011111000000000001111111000000111xx
10000000000000000000000000000000000001111 xxxxxx
1111111000000000000000000000000000000111111xxxxx
11111111111111111111111000000000000011111111xxxx
111111111111111001  10000000000000011111111111xx
1111111111111111  1111111111111111111111111111



