NO ./textures/north
C 225,30,0
EA ./textures/east


F 220,100,0

SO ./textures/south
WE ./textures/west


11111111111111111
11111111S11111111
11111111111111111
