NO ./textures/north.xpm
C 225,30,0
EA ./textures/east.xpm
F 220,100,0
SO ./textures/south.xpm
WE ./textures/west.xpm


11111111111111111
11111100000111111
11111100E00111111
11111111111111111


