NO ./textures/north
C 225,30,0
EA ./textures/east

F 220,100,0


SO ./textures/south
WE ./textures/west

   11111111111
   11110W00011              
   1101111111
11111111111111       
111111
111111
1111111